111111111111111111111111111111
100000000000000000000000000001
101111111111100000000000001001
100000000000100011111111101001
100000000000100000000000000001
100000011111111000000000000001
100000000000000000111111111001
101111111000000000000000000001
100000000000111110000000000001
100011111100000000000011111101
100000000000000000000000000001
100000011111111000111111111001
101111100000000000000000000001
100000000000111111000000000001
100000000000000000000000000001
100011111111111111000000111101
100000000000000000000000000001
111111111111111111111111111101
1P00000000000000000000000E0001
111111111111111111111111111111
