1111111111111
1000O000000C1
1010011111011
1P1011E000001
1111111111111