111111111111111111111111111111
1P0000000010000000000000000011
100001111101111111110000000001
100001000000000000000001111001
111001111111111111000001C00001
100000000000000001111001111001
100011110001110000000001000001
100010000001000000000111100001
100011111111000011111100000001
100000001111000000000000000001
111111111111111100011111000001
1C00000000100000000000100000E1
100111110001111000011110001101
100000000000000000000000001001
100000011111111111100001111001
100C00000000000000000000000001
111111111111111111111111111111
