1111111111111
10000000000C1
1010011111001
1P1011E000001
1111111111111