1111111111111
1P00000000001
1010011111001
100000C0000E1
1010011001001
1C00000000001
1111111111111