NO textures/wall_north.xpm
SO textures/wall_south.xpm
WE textures/wall_west.xpm
EA textures/wall_east.xpm
D textures/door1.xpm

F 80, 80, 80
C 70, 70, 90

1111111111        111111111
100000000111111111110000011
101111110000000000000000011
1010000D0111111111111111111
1010N10101
10D0000101
1011D01101
1000000001
1111111111