NO textures/wall_north1.xpm
SO textures/wall_south1.xpm
WE textures/wall_west1.xpm
EA textures/wall_east1.xpm

C 135,206,235
F 124, 252, 0

        1111111111111111111111111
        1001111111111111111111111
111111111001111111111111111111111
1100S0000001111111111111111111111
100001111111111111111111111111111
111111 11111111111111111111111111
