NO textures/wall_north.xpm
SO textures/wall_south.xpm
WE textures/wall_west.xpm
EA textures/wall_east.xpm

F 80, 80, 80
C 70, 70, 90

1



11111
1   1
1  N1
11111