NO textures/wall_north.xpm
SO textures/wall_south.xpm
WE textures/wall_west.xpm
EA textures/wall_east.xpm

F 80, 80, 80
C 70, 70, 90

1111111111        111111111
100000000111111111110000011
101111110000000000000000011
101000010111111111111111111
1010N10101
1010000101
1011101101
1000000001
1111111111