F 255, 192, 203
C 255, 105, 180

1111111111111
1110011100111
1100001000011
1110000E0011
11110000011
1111100011
11111101
   1111