NO textures/wall_north.xpm
SO textures/wall_south.xpm
WE textures/wall_west.xpm
EA textures/wall_east.xpm
D textures/door1.xpm

C 135,206,235
F 124, 252, 0

        1111111111111111111111111
        1000001111111111111111111
111111111001111111111111111111111
1100S0000001111111111111111111111
100001111111111111111111111111111
111111 11111111111111111111111111
