NO textures/wall_north.xpm
SO textures/wall_south.xpm
WE textures/wall_west.xpm
EA textures/wall_east.xpm
D textures/door1.xpm

F 80, 80, 80
C 70, 70, 90

1111111111        111111111
10C000D00111111111111000011
10011101000D000000C00000011
1101 100011111111111111111
10D1 101011
1011 10101
101111W101
100DC00D01
1111111111
